NO ./textures/no.png
SO ./textures/so.png
WE ./textures/we.png 
EA ./textures/ea.png

C 0,220,255
F 255,255,255


1111     1         
1001       
100N1
111111
1    1
111111   1