NO ./textures/no_empty.xpm
SO ./textures/no_empty.xpm
WE ./textures/no_empty.xpm 
EA ./textures/no_empty.xpm

F 244,255,0
C 220,100,66


11111111111111111111111
10111111111111111101101
11111111E11111111111111
11111111111111111111111
11111111111111101111111
11111111111111111111111
11111101111111111111011
10111111111111111111101
11111111111111111111111