C 0,220,255

EA ./textures/key_codes.png 

F    0,78,1     


NO ./textures/no_s.png


SO ./textures/so_s.png


WE ./textures/ea.png


1      1111111111111111111111111
        10000000011000000000001
        101100000111000000000001
        1000100000000000000000001
111111111011000001110000000000001
100000000011000001110111111111111                 11111
11110111111111011100000010001                    111011
11110111111111011101010010001                    111011
11000000110101011100100010001                    111111
10000000000000001100000010001
100000000000000011010100100011111111
1100000111010101111101111010111
11100111 1110101 101111010001
11100111111111111111110010011
11100111111111111111110010011
11100111 111111 111111001001
11100111111111111111111010011
11000000110101011100000010001
10000000000000000000000000000111111
11111000000000011010100100010000001
11111111111111111111111111111111111
1      1111111111111111111111111
        10000000011000000000001
        101100000111000000000001
        1000100000000000000000001
111111111011000001110000000000001
100000000011000001110111111111111                 11111
11110111111111011100000010001                    111011
11110111111111011101010010001                    111011
11000000110101011100000010001                    111111                                 
10000000000000001100000010001
100000000000000011010100100011111111
1100000111010101111101111010111
11100111 1110101 101111010001
11100111111111111111110010011
11100111111111111111110010011
11100111 111111 111111001001
11100111111111111111111010011
11000000110101011100000010001
10000000000000000000001000000111111                                                     1
11111000000000011010100100010000001                                                    101      
11111111111111111111111111111111111                                                   10101
                                                                                       1111
                                                                                                                                                                              11
                                                                                                                                                                                                                                                                     11                                                                                       11                                                                                       11                                                                                       11                                                                                       11                                                                                       11                                                                                       11                                                                                       11                                                                                       11                                                                                       11                                                                                       11                                                                                       11                                                                                       11                                                                                       11                                                                                       11                                                                                       11                                                                                       11                                                                                       11                                                                                       11                                                                                       11                                                                                       11                                                                                       11                                                                                       11                                                                                       11                                                                                       11                                                                                       11                                                                                       11                                                                                       11                                                                                       11                                                                                       11                                                                                       11                                                                                       11                                                                                       11                                                                                       11                                                                                       11 1                                                                                     11                                                                                       11
                                                                                                                                                                                                                                                                        11                                                                                      11                                                                                       11                                                                                       11                                                                                       11                                                                                       11                                                                                       11                                                                                       11                                                                                       11                                                                                       11                                                                                       11                                                                                       11                                                                                       11                                                                                       11                                                                                       11                                                                                       11                                                                                       11                                                                                       11                                                                                       11                                                                                       11                                                                                       11                                                                                       11                                                                                       11                                                                                       11                                                                                       11                                                                                       11                                                                                       11                                                                                       11                                                                                       11                                                                                       11                                                                                       11                                                                                       11                                                                                       11                                                                                       11                                                                                       1N1
                                                                                                                                                                                                                                                                        11                                                                                      11                                                                                       11                                                                                       11                                                                                       11                                                                                       11                                                                                       11                                                                                       11                                                                                       11                                                                                       11                                                                                       11                                                                                       11                                                                                       11                                                                                       11                                                                                       11                                                                                       11                                                                                       11                                                                                       11                                                                                       11                                                                                       11                                                                                       11                                                                                       11                                                                                       11                                                                                       11                                                                                       11                                                                                       11                                                                                       11                                                                                       11                                                                                       11                                                                                       11                                                                                       11                                                                                       11                                                                                       11                                                                                       11                                                                                       11