EA ./textures/small_no.xpm
NO ./textures/small_no.xpm
SO ./textures/small_no.xpm
WE ./textures/small_no.xpm

F 244,255,0
C 220,100,66







1      1111111111111111111111111
        1000000000110000000000001
        1011000001110000000000001
        1000100000000000000000001
111111111011000001110000000000001
100000000011000001110111111111111                 11111
11110111111111011100000010001                    111011
11110111111111011101010010001                    111011
11000000110101011100000010001                    111111
10000000000000001100000010001
100000000000000011010100100011111111
11000001110101011111011110N0111
11100111 1110101 101111010001
11100111111111111111110010011
11100111111111111111110010011
11100111 111111 111111001001
11100111111111111111111010011
11000000110101011100000010001
10000000000000000000000000001
10000000000000001101010010001
11111111111111111111111111111