EA ./path_to_the_east_texture
NO ./path_to_the_north_texture
SO      ./path_to_the_south_texture
WE ./path_to_the_west_texture 

F 244,255,0
C 220,100,66


111111111111111111111111111
100000000011000000000000101
101100000111000000000000101
100100000000000000000000101
111111111011000001110001101
100000000011000001110111101
111101111111110111000001101
111101111111110111010100101
110000001101010111000000001
100000000000000011000000011
100000000000N00011010000011
110000011101010111110001101
11110111 1110101 1011000101
11111111 1111111 1111111111
