NO ./textures/no_s.png
SO ./textures/so_s.png
WE ./textures/key_codes.png 
EA ./textures/ea.png

C 0,220,255
F 255,255,255



111111111111111111111111111
100000000011000000000000101
101100000111000000000000101
100100000000000000000000101
111111111011000001110001101
111111111011000001110001101
111111111011000001110001101
111111111011000001110001101
111111111011000001110001101
111111111011000001110001101
111111111011000001110001101
111111111011000001110001101
111111111011000001110001101
111111111011000001110001101
100000000011000001110111101
100000000011000001110111101
100000000011000001110111101
100000000011000001110111101
100000000011000001110111101
100000000011000001110111101
100000000011000001110111101
101100000111000000000000101
100100000000000000000000101
111111111011000001110001101
111111111011000001110001101
111111111011000001110001101
100000000011000001110111101
100000000011000001110111101
100000000011000001110111101
100000000011000001110111101
100000000011000001110111101
100000000011000001110111101
100000000011000001110111101
101100000111000000000000101
100100000000000000000000101
111111111011000001110001101
111111111011000001110001101
111111111011000001110001101
111111111011000001110001101
111111111011000001110001101
111111111011000001110001101
111111111011000001110001101
111111111011000001110001101
111111111011000001110001101
111111111011000001110001101
100000000011000001110111101
100000000011000001110111101
100000000011000001110111101
100000000011000001110111101
100000000011000001110111101
100000000011000001110111101
100000000011000001110111101
101100000111000000000000101
100100000000000000000000101
111111111011000001110001101
111111111011000001110001101
111111111011000001110001101
100000000011000001110111101
100000000011000001110111101
100000000011000001110111101
100000000011000001110111101
100000000011000001110111101
100000000011000001110111101
100000000011000001110111101
101100000111000000000000101
111111111011000001110001101
111111111011000001110001101
111111111011000001110001101
111111111011000001110001101
111111111011000001110001101
111111111011000001110001101
111111111011000001110001101
111111111011000001110001101
111111111011000001110001101
111111111011000001110001101
100000000011000001110111101
10000000001100000111N111101
100000000011000001110111101
100000001011000011110111101
11110111 1110101 1011000101
11111111 1111111 1111111111
