EA ./textures/small_no.xpm
NO ./textures/small_no.xpm
SO ./textures/small_no.xpm
WE ./textures/small_no.xpm

F 244,255,0
C 220,100,66



111111111111111111
1000000000N0000001
100000010000000001
100000000000000001
111111111111111111
