NO ./textures/no_s.png
SO ./textures/so_s.png
WE ./textures/key_codes.png 
EA ./textures/ea.png

C 0,220,255
F 255,255,255




111111111111111111
1000000000N0000001
100000010000000001
100000000000000001
111111111111111111
