EA       ./test.cub
            SO     ./test.cub
NO ./test.cub
WE ./test.cub

             
C 220,54,45
F 22,2,0
  
         

     11111    1111111111
              1000000001
              1000000001        1111111
              1000000001        1000001
              1111111111        1111111
 
1 11              1
N100111111
1 11      111111111
         1000000001
         1000000001
         1111111111
    
 
         1111111111
          100000001
         1111111111
1111111111
1111111111
1111111111